2 2 2 2 2 2 2 2 2 2 2 2 2 2 2 2 2 2 2 2 2 2 2 2 2 2 2 2 2 2 2 2 2 2 2 2 2 2 2 2 2 2 2 2 2 2 2 2 2 2
2 2 2 2 2 2 2 2 2 2 2 2 2 2 2 2 2 2 2 2 2 2 2 2 2 2 2 2 2 2 2 2 8 2 2 2 2 2 2 2 2 2 2 2 2 2 2 2 2 2
2 2 2 2 2 2 2 2 2 2 2 2 2 2 2 2 2 2 2 2 2 2 2 2 2 2 2 2 2 2 2 2 2 2 2 2 2 2 2 2 2 2 2 2 2 2 2 2 2 2
2 2 2 2 2 2 2 2 2 2 2 2 2 2 2 2 2 2 2 2 2 2 2 2 8 2 2 2 2 2 2 2 2 2 2 2 2 2 2 2 2 2 2 2 2 2 2 2 2 2 
2 2 2 2 2 2 2 2 2 2 2 8 2 2 2 2 2 8 2 2 2 2 2 2 2 2 2 2 2 2 2 2 2 2 2 2 8 2 2 2 2 2 2 2 2 2 8 2 2 2
2 2 2 2 2 2 2 2 2 2 2 2 2 2 2 2 2 2 2 2 2 2 2 2 2 2 2 2 2 8 2 2 2 2 2 2 2 2 2 2 2 2 2 2 2 2 2 2 2 2
2 2 2 2 2 2 2 2 2 2 2 2 2 2 8 2 2 2 2 2 2 8 2 2 2 2 2 2 2 23 9 24 9 9 24 9 24 9 24 9 16 8 2 2 2 2 2 2 2 2
2 2 2 2 2 2 2 8 2 2 2 2 2 2 2 2 2 2 23 9 24 9 9 24 24 9 9 24 9 10 0 0 0 0 0 0 0 0 0 0 14 9 16 2 2 2 2 2 2 2 
2 2 2 2 2 2 2 2 2 2 2 2 2 2 23 24 9 9 10 0 0 0 0 5 0 0 0 0 0 0 0 0 0 6 0 0 0 0 6 0 0 0 14 16 2 2 8 2 2 2
2 2 2 2 2 2 2 2 2 2 2 2 2 23 10 0 0 6 0 0 0 6 0 5 0 6 0 0 0 6 0 0 0 0 0 0 0 0 0 0 0 6 0 17 2 2 2 2 2 2
2 2 2 2 2 2 2 2 2 2 8 2 23 10 0 0 0 0 0 0 0 0 0 5 0 0 0 0 0 0 0 13 12 12 11 0 0 0 0 0 0 0 0 17 2 2 2 2 2 2
2 2 2 2 2 2 2 2 2 2 2 23 10 0 0 6 0 0 0 6 0 4 0 5 0 4 0 0 0 0 13 18 2 2 20 11 0 4 6 0 0 0 0 17 2 8 2 2 2 
2 2 2 2 2 2 2 2 2 2 23 10 0 0 0 0 5 5 5 0 0 0 0 5 0 0 0 6 0 0 17 2 8 2 2 21 0 4 4 4 4 0 0 17 2 2 2 2 2 2
2 2 2 2 2 2 2 8 2 2 21 0 6 0 0 5 5 5 5 5 0 0 0 5 0 0 0 0 0 0 14 16 2 8 23 10 0 4 4 4 5 0 0 17 2 2 2 2 2 2
2 2 2 2 2 2 2 2 2 2 21 0 0 0 0 5 5 5 5 6 0 0 0 5 0 6 0 0 6 0 0 14 24 9 10 0 0 0 4 4 5 6 13 18 8 2 2 2 2 2
2 2 2 8 2 2 2 2 2 2 21 0 0 0 0 0 5 5 4 0 0 0 4 5 4 4 4 0 0 0 6 0 0 0 0 0 0 0 0 4 5 0 17 2 2 2 2 2 2 2
2 2 2 2 2 2 2 2 2 23 10 0 0 4 6 0 0 5 0 0 0 0 0 5 4 4 4 0 0 0 0 5 0 0 6 0 0 0 6 0 5 0 17 2 2 2 2 2 2 2
2 2 2 2 2 2 2 2 2 21 0 6 0 0 0 0 0 5 6 0 0 6 0 5 0 4 4 6 0 0 0 5 4 0 0 0 0 0 0 0 5 0 17 2 2 2 2 2 2 2
2 2 2 2 2 2 8 2 23 10 0 0 0 0 0 0 4 5 0 0 4 0 0 5 4 0 4 4 4 0 4 5 6 0 0 0 0 0 0 0 5 0 17 2 2 2 2 8 2 2 
2 2 2 2 2 2 2 2 21 0 0 0 4 0 0 6 0 5 0 0 0 0 0 5 0 6 0 4 4 0 6 5 5 0 0 6 0 0 0 6 5 6 17 2 2 2 2 2 2 2
2 2 2 2 2 2 2 23 10 0 0 0 0 0 0 0 0 5 6 0 0 4 6 5 0 4 0 0 0 0 0 0 5 4 0 0 0 0 0 0 5 13 18 2 2 2 2 2 2 2
2 2 2 8 2 2 23 10 0 0 5 5 5 5 5 5 5 5 5 5 5 5 5 5 5 5 5 5 5 5 5 5 5 5 5 5 5 5 5 5 5 17 2 8 2 2 2 2 2 2
2 2 2 2 2 2 21 0 0 0 5 0 0 0 6 0 0 4 0 0 0 0 0 5 0 0 0 0 0 0 0 0 0 0 0 0 4 4 4 4 0 17 2 2 2 2 2 2 8 2 
2 2 2 2 2 23 10 0 0 0 5 0 0 0 0 0 0 0 0 0 6 0 0 5 0 0 0 6 0 0 0 0 0 6 0 4 4 4 4 4 0 14 16 2 2 2 2 2 2 2
2 2 2 2 2 22 0 0 0 0 5 0 0 4 0 0 0 0 0 0 0 0 0 5 4 0 0 4 0 0 0 0 0 0 0 0 4 4 4 6 0 0 17 2 2 2 2 2 2 2
2 2 2 2 2 21 0 0 6 0 5 0 6 0 0 0 6 0 0 0 4 0 0 5 0 0 6 0 0 4 6 0 0 4 0 0 6 0 4 4 0 0 17 2 2 8 2 2 2 2
2 2 2 2 2 22 0 0 0 0 5 0 0 0 0 0 0 0 6 0 0 0 4 5 0 0 0 0 0 0 0 0 0 0 0 4 0 0 0 0 6 0 17 2 2 2 2 2 2 2 
2 2 2 2 8 21 5 5 5 5 5 0 4 0 0 0 0 0 0 0 0 0 0 5 0 0 4 0 0 1 1 1 1 1 0 0 0 0 0 0 0 0 17 2 2 2 2 2 2 2
2 2 2 2 2 21 6 0 0 0 5 0 0 0 0 0 6 4 0 0 0 0 0 5 0 6 0 0 0 1 7 7 7 1 4 0 0 0 0 0 0 0 17 2 2 2 2 2 2 2
2 2 2 2 2 22 0 0 0 0 5 0 6 0 0 4 4 4 4 0 6 0 0 5 0 0 0 0 0 1 7 7 7 1 4 4 0 0 6 0 0 0 17 2 8 2 2 2 2 2
2 2 2 2 2 22 0 0 0 0 5 0 0 0 0 4 4 4 4 4 0 0 0 5 0 0 0 4 0 1 7 7 7 1 4 6 0 0 0 0 0 13 18 2 2 2 2 2 2 2
2 2 2 8 2 21 0 0 6 0 5 0 0 0 0 6 0 4 4 0 0 0 0 5 0 0 0 6 0 1 7 7 7 1 4 4 0 0 0 0 0 17 2 2 2 2 2 2 2 2
2 2 2 2 2 20 11 0 0 0 5 5 5 5 5 0 4 4 4 6 0 0 6 5 0 0 0 0 0 1 1 7 1 1 4 0 0 0 0 6 0 17 2 2 2 2 2 2 2 2
2 2 2 2 2 2 20 11 0 0 0 0 6 0 5 0 0 0 0 0 0 4 0 5 0 6 4 0 0 0 0 5 0 0 0 0 6 0 0 0 0 17 2 2 2 8 2 2 2 2 
2 2 2 2 2 2 2 22 0 0 0 0 0 4 5 5 5 5 5 5 5 5 5 5 0 0 0 0 0 0 0 5 0 0 0 0 0 0 0 0 13 18 2 2 2 2 2 2 2 2
2 2 2 2 2 8 2 20 11 0 0 0 0 0 0 0 0 0 0 0 0 0 0 5 0 0 0 0 0 0 0 5 0 0 0 0 0 0 0 0 17 2 2 2 2 2 2 2 2 2
2 2 2 2 2 2 2 2 21 0 0 4 4 4 6 4 4 0 0 0 0 0 0 5 0 0 6 0 0 0 0 5 0 0 6 0 0 0 0 13 18 2 8 2 2 2 2 2 2 2
2 2 2 2 2 2 2 2 22 0 0 0 4 4 4 4 4 4 0 6 0 0 0 5 5 5 5 5 5 5 5 5 0 0 0 0 0 6 0 17 2 2 2 2 2 2 2 2 2 2 
2 2 2 2 2 2 2 2 21 0 0 6 0 4 4 4 4 4 0 0 0 4 0 6 0 0 0 6 0 0 0 6 0 0 0 0 0 0 0 17 2 2 2 2 2 8 2 2 2 2
2 2 2 8 2 2 2 8 22 0 0 0 0 4 4 4 6 0 0 0 4 4 4 0 0 0 0 0 0 0 0 0 0 0 0 0 0 13 19 18 2 2 2 2 2 2 2 2 2 2
2 2 2 2 2 2 2 2 20 11 0 0 0 0 4 0 0 0 0 4 4 4 4 0 0 0 0 0 0 0 0 0 0 0 0 0 0 17 2 2 2 2 2 2 2 2 2 2 2 2
2 2 2 2 2 2 2 2 2 22 0 0 0 0 0 0 0 4 4 4 4 4 0 0 0 6 0 0 0 0 0 0 0 0 6 0 13 18 2 2 2 2 8 2 2 2 2 2 2 2 
2 2 2 2 2 2 2 2 2 21 0 0 0 0 0 0 0 0 4 4 4 0 0 0 0 0 0 0 0 0 6 0 0 0 0 0 17 2 2 2 2 2 2 2 2 2 2 2 2 2
2 2 2 2 2 2 2 2 2 20 19 19 11 0 0 0 0 0 0 0 0 0 0 0 0 0 0 0 0 0 0 0 13 19 19 19 18 2 8 2 2 2 2 2 2 2 2 2 2 2
2 2 2 2 2 2 2 2 2 2 2 2 20 19 19 19 19 11 0 0 0 0 0 0 0 0 0 0 13 19 19 19 18 2 2 2 2 2 2 2 2 2 2 2 2 2 2 2 2 2
2 2 2 2 2 2 2 2 2 2 2 2 2 2 2 2 2 20 19 19 19 19 19 19 19 19 19 19 18 2 2 2 2 2 8 2 2 2 2 2 2 2 2 2 2 2 2 2 2 2 
2 2 2 2 2 2 2 2 2 2 2 2 2 2 2 2 2 2 8 2 2 2 2 2 8 2 2 2 2 2 2 2 2 2 2 2 2 2 2 2 2 2 2 2 2 2 2 2 2 2
2 2 2 2 2 2 2 8 2 2 2 8 2 2 2 2 2 2 2 2 2 2 2 2 2 2 2 2 2 2 8 2 2 2 2 2 2 2 2 2 8 2 2 2 2 2 2 2 2 2
2 2 2 2 2 2 2 2 2 2 2 2 2 2 2 2 2 2 2 2 2 2 2 2 2 2 2 2 2 2 2 2 2 2 2 2 2 2 2 2 2 2 2 2 2 2 2 2 2 2
2 2 2 2 2 2 2 2 2 2 2 2 2 2 2 2 2 2 2 2 2 2 2 2 2 2 2 2 2 2 2 2 2 2 2 2 2 2 2 2 2 2 2 2 2 2 2 2 2 2 