2 2 2 2 2 2 2 2 2 2 2 2 2 2 2 2 2 2 2 2 2 2 2 2 2 2 2 2 2 2 2 2 2 2 2 2 2 2 2 2 2 2 2 2 2 2 2 2 2 2
2 2 2 2 2 2 2 2 2 2 2 2 2 2 2 2 2 2 2 2 2 2 2 2 2 2 2 2 2 2 2 2 2 2 2 2 2 2 2 2 2 2 2 2 2 2 2 2 2 2
2 2 2 2 2 2 2 2 2 2 2 2 2 2 2 2 2 2 2 2 2 2 2 2 2 2 2 2 2 2 2 2 2 2 2 2 2 2 2 2 2 2 2 2 2 2 2 2 2 2
2 2 2 2 2 2 2 2 2 2 2 2 2 2 2 2 2 2 2 2 2 2 2 2 2 2 2 2 2 2 2 2 2 2 2 2 2 2 2 2 2 2 2 2 2 2 2 2 2 2 
2 2 2 2 2 2 2 2 2 2 2 2 2 2 2 2 2 2 2 2 2 2 2 2 2 2 2 2 2 2 2 2 2 2 2 2 2 2 2 2 2 2 2 2 2 2 2 2 2 2
2 2 2 2 2 2 2 2 2 2 2 2 2 2 2 2 2 2 2 2 2 2 2 2 2 2 2 2 2 2 2 2 2 2 2 2 2 2 2 2 2 2 2 2 2 2 2 2 2 2
2 2 2 2 2 2 2 2 2 2 2 2 2 2 2 2 2 2 2 2 2 2 2 2 2 2 2 2 2 2 2 2 2 2 2 2 2 2 2 2 2 2 2 2 2 2 2 2 2 2
2 2 2 2 2 2 2 2 2 2 2 2 2 2 2 2 2 2 2 2 2 2 2 2 2 2 2 2 2 0 0 0 0 0 0 0 0 0 0 0 2 2 2 2 2 2 2 2 2 2 
2 2 2 2 2 2 2 2 2 2 2 2 2 2 2 2 2 2 2 0 0 1 1 5 1 1 0 0 0 0 0 0 0 6 0 0 0 0 6 0 0 0 2 2 2 2 2 2 2 2
2 2 2 2 2 2 2 2 2 2 2 2 2 2 2 0 0 6 0 0 0 6 0 5 0 6 0 0 0 6 0 5 5 5 5 0 0 0 0 0 0 6 0 2 2 2 2 2 2 2
2 2 2 2 2 2 2 2 2 2 2 2 2 2 0 0 0 0 0 0 0 0 0 5 0 0 0 0 0 0 5 2 2 2 2 5 0 0 0 0 0 0 0 2 2 2 2 2 2 2
2 2 2 2 2 2 2 2 2 2 2 2 2 0 0 6 0 0 0 6 0 4 0 5 0 4 0 0 0 5 2 2 2 2 2 2 5 0 4 6 0 0 0 2 2 2 2 2 2 2 
2 2 2 2 2 2 2 2 2 2 2 2 0 0 0 0 5 5 5 0 0 0 0 5 0 0 0 6 0 5 2 2 2 2 2 2 5 4 4 4 4 0 0 2 2 2 2 2 2 2
2 2 2 2 2 2 2 2 2 2 2 0 6 0 0 5 5 5 5 5 0 0 0 5 0 0 0 0 0 5 2 2 2 2 2 2 5 4 4 4 5 0 0 2 2 2 2 2 2 2
2 2 2 2 2 2 2 2 2 2 2 0 0 0 0 5 5 5 5 6 0 0 0 5 0 6 0 0 6 0 5 2 2 2 2 5 0 0 4 4 5 6 2 2 2 2 2 2 2 2
2 2 2 2 2 2 2 2 2 2 2 0 0 0 0 0 5 5 4 0 0 0 4 5 0 0 4 0 0 0 6 5 5 5 5 0 0 0 0 4 5 0 2 2 2 2 2 2 2 2
2 2 2 2 2 2 2 2 2 2 2 0 0 4 6 0 0 5 0 0 0 0 0 5 0 0 0 0 0 0 0 5 0 0 6 0 0 0 6 0 5 0 2 2 2 2 2 2 2 2
2 2 2 2 2 2 2 2 2 2 0 6 0 0 0 0 0 5 6 0 0 6 0 5 0 0 0 6 0 0 0 5 4 0 0 0 0 0 0 0 5 0 2 2 2 2 2 2 2 2
2 2 2 2 2 2 2 2 2 2 0 0 0 0 0 0 4 5 0 0 4 0 0 5 4 0 0 0 0 0 4 5 6 0 0 0 0 0 0 0 5 0 2 2 2 2 2 2 2 2 
2 2 2 2 2 2 2 2 2 0 0 0 4 0 0 6 0 5 0 0 0 0 0 5 0 6 0 4 0 0 6 5 5 0 0 6 0 0 0 6 5 6 2 2 2 2 2 2 2 2
2 2 2 2 2 2 2 2 2 0 0 0 0 0 0 0 0 5 6 0 0 4 6 5 0 4 0 0 0 0 0 0 5 4 0 0 0 0 0 0 5 2 2 2 2 2 2 2 2 2
2 2 2 2 2 2 2 2 0 0 5 5 5 5 5 5 5 5 5 5 5 5 5 5 5 5 5 5 5 5 5 5 5 5 5 5 5 5 5 2 2 2 2 2 2 2 2 2 2 2
2 2 2 2 2 2 2 0 0 0 5 0 0 0 6 0 0 4 0 0 0 0 0 5 0 0 0 0 0 0 0 0 0 0 0 0 4 4 4 4 0 2 2 2 2 2 2 2 2 2 
2 2 2 2 2 2 2 0 0 0 5 0 0 0 0 0 0 0 0 0 6 0 0 5 0 0 0 6 0 0 0 0 0 6 0 4 4 4 4 4 0 2 2 2 2 2 2 2 2 2
2 2 2 2 2 2 0 0 0 0 5 0 0 4 0 0 0 0 0 0 0 0 0 5 4 0 0 4 0 0 0 0 0 0 0 0 4 4 4 6 0 0 2 2 2 2 2 2 2 2
2 2 2 2 2 2 1 0 6 0 5 0 6 0 0 0 6 0 0 0 4 0 0 5 0 0 6 0 0 4 6 0 0 4 0 0 6 0 4 4 0 0 2 2 2 2 2 2 2 2
2 2 2 2 2 2 1 0 0 0 5 0 0 0 0 0 0 0 6 0 0 0 4 5 0 0 0 0 0 0 0 0 0 0 0 4 0 0 0 0 6 0 2 2 2 2 2 2 2 2 
2 2 2 2 2 2 5 5 5 5 5 0 4 0 0 0 0 0 0 0 0 0 0 5 0 0 4 0 0 1 1 1 1 1 0 0 0 0 0 0 0 0 2 2 2 2 2 2 2 2
2 2 2 2 2 2 1 0 0 0 5 0 0 0 0 0 6 4 0 0 0 0 0 5 0 6 0 0 0 1 7 7 7 1 0 0 0 0 0 0 0 0 2 2 2 2 2 2 2 2
2 2 2 2 2 2 1 0 0 0 5 0 6 0 0 4 4 4 4 0 6 0 0 5 0 0 0 0 0 1 7 7 7 1 0 0 0 0 6 0 0 0 2 2 2 2 2 2 2 2
2 2 2 2 2 2 0 0 0 0 5 0 0 0 0 4 4 4 4 4 0 0 0 5 0 0 0 4 0 1 7 7 7 1 0 6 0 0 0 0 0 2 2 2 2 2 2 2 2 2
2 2 2 2 2 2 2 0 6 0 5 0 0 0 0 6 0 4 4 0 0 0 0 5 0 0 0 6 0 1 7 7 7 1 0 0 0 0 0 0 0 2 2 2 2 2 2 2 2 2
2 2 2 2 2 2 2 0 0 0 5 5 5 5 5 0 4 4 4 6 0 0 6 5 0 0 0 0 0 1 1 7 1 1 0 0 0 0 0 6 0 2 2 2 2 2 2 2 2 2
2 2 2 2 2 2 2 2 0 0 0 0 6 0 5 0 0 0 0 0 0 4 0 5 0 6 4 0 0 0 0 5 0 0 0 0 6 0 0 0 0 2 2 2 2 2 2 2 2 2 
2 2 2 2 2 2 2 2 0 0 0 0 0 4 5 5 5 5 5 5 5 5 5 5 0 0 0 0 0 0 0 5 0 0 0 0 0 0 0 0 2 2 2 2 2 2 2 2 2 2
2 2 2 2 2 2 2 2 2 0 0 0 0 0 0 0 0 0 0 0 0 0 0 5 0 0 0 0 0 0 0 5 0 0 0 0 0 0 0 0 2 2 2 2 2 2 2 2 2 2
2 2 2 2 2 2 2 2 2 0 0 4 4 4 6 4 4 0 0 0 0 0 0 5 0 0 6 0 0 0 0 5 0 0 6 0 0 0 0 2 2 2 2 2 2 2 2 2 2 2
2 2 2 2 2 2 2 2 2 0 0 0 4 4 4 4 4 4 0 6 0 0 0 5 5 5 5 5 5 5 5 5 0 0 0 0 0 6 0 2 2 2 2 2 2 2 2 2 2 2 
2 2 2 2 2 2 2 2 2 0 0 6 0 4 4 4 4 4 0 0 0 4 0 6 0 0 0 6 0 0 0 6 0 0 0 0 2 2 0 2 2 2 2 2 2 2 2 2 2 2
2 2 2 2 2 2 2 2 2 0 0 0 0 4 4 4 6 0 0 0 4 4 4 0 0 0 0 0 0 0 0 0 0 0 0 0 2 2 2 2 2 2 2 2 2 2 2 2 2 2
2 2 2 2 2 2 2 2 2 2 0 0 0 0 4 0 0 0 0 4 4 4 4 0 0 0 0 0 0 0 0 0 0 0 0 0 2 2 2 2 2 2 2 2 2 2 2 2 2 2
2 2 2 2 2 2 2 2 2 2 0 0 0 0 0 0 0 4 4 4 4 4 0 0 0 6 0 0 0 0 0 0 0 0 6 0 2 2 2 2 2 2 2 2 2 2 2 2 2 2 
2 2 2 2 2 2 2 2 2 2 0 0 0 0 0 0 0 0 4 4 4 0 0 0 0 0 0 0 0 0 6 0 0 0 0 0 2 2 2 2 2 2 2 2 2 2 2 2 2 2
2 2 2 2 2 2 2 2 2 2 2 2 2 0 0 0 0 0 0 0 0 0 0 0 0 0 0 0 0 0 0 0 2 2 2 2 2 2 2 2 2 2 2 2 2 2 2 2 2 2
2 2 2 2 2 2 2 2 2 2 2 2 2 2 2 2 2 2 0 0 0 0 0 0 0 0 0 0 2 2 2 2 2 2 2 2 2 2 2 2 2 2 2 2 2 2 2 2 2 2
2 2 2 2 2 2 2 2 2 2 2 2 2 2 2 2 2 2 2 2 2 2 2 2 2 2 2 2 2 2 2 2 2 2 2 2 2 2 2 2 2 2 2 2 2 2 2 2 2 2 
2 2 2 2 2 2 2 2 2 2 2 2 2 2 2 2 2 2 2 2 2 2 2 2 2 2 2 2 2 2 2 2 2 2 2 2 2 2 2 2 2 2 2 2 2 2 2 2 2 2
2 2 2 2 2 2 2 2 2 2 2 2 2 2 2 2 2 2 2 2 2 2 2 2 2 2 2 2 2 2 2 2 2 2 2 2 2 2 2 2 2 2 2 2 2 2 2 2 2 2
2 2 2 2 2 2 2 2 2 2 2 2 2 2 2 2 2 2 2 2 2 2 2 2 2 2 2 2 2 2 2 2 2 2 2 2 2 2 2 2 2 2 2 2 2 2 2 2 2 2
2 2 2 2 2 2 2 2 2 2 2 2 2 2 2 2 2 2 2 2 2 2 2 2 2 2 2 2 2 2 2 2 2 2 2 2 2 2 2 2 2 2 2 2 2 2 2 2 2 2 